Barcode,Individual,Total,NoRadTag,LowQuality,Retained
GCATG,COPE-0594,3779644,11745,0,3767899
AACCA,COPE-0848,7925244,31160,0,7894084
CGATC,COPE-0557,3007074,32053,0,2975021
TCGAT,COPE-1226,6304642,10890,0,6293752
TGCAT,COPE-1190,1625634,4524,0,1621110
CAACC,COPE-0902,3456242,11224,0,3445018
GGTTG,COPE-0788,19938034,17159,0,19920875
AAGGA,COPE-0831,26340408,89191,0,26251217
AGCTA,COPE-0666,184266,11261,0,173005
ACACA,COPE-1064,564926,9231,0,555695
AATTA,COPE-0833,21453682,66293,0,21387389
ACGGT,COPE-1006,1087144,4374,0,1082770
ACTGG,COPE-1265,1656854,6511,0,1650343
ACTTC,COPE-1202,3544752,6947,0,3537805
ATACG,COPE-0608,2489956,5403,0,2484553
ATGAG,COPE-1011,521424,2660,0,518764
ATTAC,COPE-1198,930116,34700,0,895416
CATAT,COPE-0632,709790,3039,0,706751
CGAAT,COPE-0687,644142,7239,0,636903
CGGCT,COPE-0763,10009846,32122,0,9977724
CGGTA,COPE-0599,265164,28492,0,236672
CGTAC,COPE-1073,7409510,20221,0,7389289
CGTCG,COPE-1176,2239846,7660,0,2232186
CTGAT,COPE-0481,8094998,22138,0,8072860
CTGCG,COPE-0562,54584,6110,0,48474
CTGTC,COPE-0605,509698,3377,0,506321
CTTGG,COPE-1155,2568088,9082,0,2559006
GACAC,COPE-1253,6780962,29092,0,6751870
GAGAT,COPE-0710,52226,1978,0,50248
GAGTC,COPE-1189,1010436,4129,0,1006307
GCCGT,COPE-0509,1063382,5282,0,1058100
GCTGA,COPE-0826,10342340,64542,0,10277798
GGATA,COPE-0810,362934,19700,0,343234
GGCCA,COPE-0592,3431418,18365,0,3413053
GGCTC,COPE-0829,588200,5598,0,582602
GTAGT,COPE-1118,1288008,3826,0,1284182
GTCCG,COPE-0580,656156,9750,0,646406
GTCGA,COPE-0766,2512624,14963,0,2497661
TACCG,COPE-0748,8788958,55243,0,8733715
TACGT,COPE-0758,8686340,24949,0,8661391
TAGTA,COPE-0635,480362,10179,0,470183
TATAC,COPE-0715,529966,2857,0,527109
TCACG,COPE-0473,858910,6538,0,852372
TCAGT,COPE-0896,77398,1999,0,75399
TCCGG,COPE-1077,195316,52991,0,142325
TCTGC,COPE-1168,6052478,16321,0,6036157
TGGAA,COPE-0921,9087204,55911,0,9031293
TTACC,COPE-0513,12748,2451,0,10297
GCATG,COPE-0711,5266826,18129,0,5248697
AACCA,COPE-1233,5770012,412981,0,5357031
CGATC,COPE-0929,4404866,78014,0,4326852
TCGAT,COPE-0773,4253428,8369,0,4245059
TGCAT,COPE-1135,3999014,8024,0,3990990
CAACC,COPE-1248,5726034,52430,0,5673604
GGTTG,COPE-0956,7590574,13671,0,7576903
AAGGA,COPE-0993,3111738,22423,0,3089315
AGCTA,COPE-0757,2872314,19645,0,2852669
ACACA,COPE-0630,7117684,43468,0,7074216
AATTA,COPE-0586,1936498,9857,0,1926641
ACGGT,COPE-0615,3022912,12547,0,3010365
ACTGG,COPE-0510,6651100,32249,0,6618851
ACTTC,COPE-1203,5409496,14084,0,5395412
ATACG,COPE-1138,11613714,20274,0,11593440
ATGAG,COPE-1210,6983838,18338,0,6965500
ATTAC,COPE-0523,616704,10874,0,605830
CATAT,COPE-1020,3641088,10897,0,3630191
CGAAT,COPE-1096,1987432,14729,0,1972703
CGGCT,COPE-0550,1234010,29251,0,1204759
CGGTA,COPE-0483,5181282,53243,0,5128039
CGTAC,COPE-1015,9973474,184463,0,9789011
CGTCG,COPE-0721,3980960,17268,0,3963692
CTGAT,COPE-0823,2163532,10475,0,2153057
CTGCG,COPE-1200,871706,10374,0,861332
CTGTC,COPE-0502,53962,2915,0,51047
CTTGG,COPE-0785,8211452,30268,0,8181184
GACAC,COPE-0662,4632622,41024,0,4591598
GAGAT,COPE-0961,4129228,18736,0,4110492
GAGTC,COPE-0519,1494452,6063,0,1488389
GCCGT,COPE-1042,10686816,16422,0,10670394
GCTGA,COPE-1117,6071398,46474,0,6024924
GGATA,COPE-0750,3016976,29581,0,2987395
GGCCA,COPE-1019,6770270,25954,0,6744316
GGCTC,COPE-0761,424654,4457,0,420197
GTAGT,COPE-0787,560734,3528,0,557206
GTCCG,COPE-0626,1217416,8216,0,1209200
GTCGA,COPE-0546,2393246,21343,0,2371903
TACCG,COPE-0827,49698,5699,0,43999
TACGT,COPE-0536,1055708,12425,0,1043283
TAGTA,COPE-0619,1795390,15949,0,1779441
TATAC,COPE-0601,5704792,18086,0,5686706
TCACG,COPE-1222,1968290,12524,0,1955766
TCAGT,COPE-0744,14809106,24710,0,14784396
TCCGG,COPE-1092,480596,29781,0,450815
TCTGC,COPE-0636,4547470,23346,0,4524124
TGGAA,COPE-0661,15234792,60492,0,15174300
TTACC,COPE-0699,24548504,59893,0,24488611
GCATG,COPE-0994,5988274,24091,0,5964183
AACCA,COPE-0926,10224780,43318,0,10181462
CGATC,COPE-0645,11314638,40870,0,11273768
TCGAT,COPE-0958,9452276,13849,0,9438427
TGCAT,COPE-1115,11641042,16751,0,11624291
CAACC,COPE-1075,8556084,15653,0,8540431
GGTTG,COPE-0962,2131290,3988,0,2127302
AAGGA,COPE-1146,12681420,48510,0,12632910
AGCTA,COPE-1219,4219594,24215,0,4195379
ACACA,COPE-0871,3566576,16295,0,3550281
AATTA,COPE-0850,1196848,5984,0,1190864
ACGGT,COPE-0624,3695550,9045,0,3686505
ACTGG,COPE-1245,7536284,10115,0,7526169
ACTTC,COPE-0723,5310862,5327,0,5305535
ATACG,COPE-1206,3334118,4225,0,3329893
ATGAG,COPE-0517,6396432,28359,0,6368073
ATTAC,COPE-1026,3249642,11320,0,3238322
CATAT,COPE-0525,7234224,14806,0,7219418
CGAAT,COPE-1259,6737678,12227,0,6725451
CGGCT,COPE-0840,5392578,18463,0,5374115
CGGTA,COPE-0639,9605282,43103,0,9562179
CGTAC,COPE-0919,4746360,17656,0,4728704
CGTCG,COPE-1143,3427216,7414,0,3419802
CTGAT,COPE-1160,9399112,16303,0,9382809
CTGCG,COPE-0505,5184346,11926,0,5172420
CTGTC,COPE-1130,1236930,4758,0,1232172
CTTGG,COPE-1236,2057184,6012,0,2051172
GACAC,COPE-0989,4053988,11934,0,4042054
GAGAT,COPE-0870,7827828,19272,0,7808556
GAGTC,COPE-1208,3357630,6602,0,3351028
GCCGT,COPE-0756,5134060,11686,0,5122374
GCTGA,COPE-0771,3879866,31606,0,3848260
GGATA,COPE-0891,4552488,31219,0,4521269
GGCCA,COPE-0621,3730640,25170,0,3705470
GGCTC,COPE-0650,8041440,14903,0,8026537
GTAGT,COPE-0813,3635020,6300,0,3628720
GTCCG,COPE-0822,9310834,15882,0,9294952
GTCGA,COPE-1147,123274,24115,0,99159
TACCG,COPE-0724,410596,6148,0,404448
TACGT,COPE-0471,3878008,8219,0,3869789
TAGTA,COPE-1184,5773468,17264,0,5756204
TATAC,COPE-0875,104406,6094,0,98312
TCACG,COPE-0877,916796,1685,0,915111
TCAGT,COPE-0952,6154116,6608,0,6147508
TCCGG,COPE-1018,1068258,20409,0,1047849
TCTGC,COPE-1071,1631140,4380,0,1626760
TGGAA,COPE-1104,198570,13676,0,184894
TTACC,COPE-0609,10558,1866,0,8692
GCATG,COPE-0767,4333810,17809,0,4316001
AACCA,COPE-0490,130796,20628,0,110168
CGATC,COPE-1252,4922430,30115,0,4892315
TCGAT,COPE-0753,5385998,7027,0,5378971
TGCAT,COPE-1221,7854418,9181,0,7845237
CAACC,COPE-1167,10342266,19154,0,10323112
GGTTG,COPE-0999,5847992,8231,0,5839761
AAGGA,COPE-1103,14412186,56727,0,14355459
AGCTA,COPE-1223,1903902,30968,0,1872934
ACACA,COPE-1067,989752,25606,0,964146
AATTA,COPE-0930,3120066,9977,0,3110089
ACGGT,COPE-0664,5568238,11171,0,5557067
ACTGG,COPE-1243,4491322,13279,0,4478043
ACTTC,COPE-0928,5685964,8500,0,5677464
ATACG,COPE-1079,13290022,19788,0,13270234
ATGAG,COPE-1169,15701628,28405,0,15673223
ATTAC,COPE-1091,1126634,10152,0,1116482
CATAT,COPE-1149,2763084,6432,0,2756652
CGAAT,COPE-0644,1600862,6794,0,1594068
CGGCT,COPE-0781,521828,14196,0,507632
CGGTA,COPE-0912,5061328,44927,0,5016401
CGTAC,COPE-0759,4478220,10538,0,4467682
CGTCG,COPE-0974,4366280,5148,0,4361132
CTGAT,COPE-1194,13220906,36590,0,13184316
CTGCG,COPE-0665,3083620,25422,0,3058198
CTGTC,COPE-0688,4082564,10173,0,4072391
CTTGG,COPE-0832,124404,1570,0,122834
GACAC,COPE-1126,14650192,49423,0,14600769
GAGAT,COPE-1072,13505006,34420,0,13470586
GAGTC,COPE-0696,6602364,16628,0,6585736
GCCGT,COPE-1001,5323256,11818,0,5311438
GCTGA,COPE-0584,22231334,93501,0,22137833
GGATA,COPE-0504,4842354,45295,0,4797059
GGCCA,COPE-0567,4095910,13926,0,4081984
GGCTC,COPE-0668,991268,3273,0,987995
GTAGT,COPE-0892,5977624,6455,0,5971169
GTCCG,COPE-0853,3223834,6785,0,3217049
GTCGA,COPE-0693,2906084,27250,0,2878834
TACCG,COPE-0819,3737142,12810,0,3724332
TACGT,COPE-1262,42896,16479,0,26417
TAGTA,COPE-0591,2779428,9439,0,2769989
TATAC,COPE-1174,7621908,17102,0,7604806
TCACG,COPE-0923,561826,9408,0,552418
TCAGT,COPE-1066,54380,2084,0,52296
TCCGG,COPE-0733,55306,20797,0,34509
TCTGC,COPE-0987,16982408,51641,0,16930767
TGGAA,COPE-0971,9847880,39521,0,9808359
TTACC,COPE-1057,9086,4161,0,4925
GCATG,COPE-0939,6945404,14933,0,6930471
AACCA,COPE-1119,9288368,36373,0,9251995
CGATC,COPE-0988,6291494,30611,0,6260883
TCGAT,COPE-1154,10459514,13766,0,10445748
TGCAT,COPE-0972,4422708,6263,0,4416445
CAACC,COPE-0851,8570622,17871,0,8552751
GGTTG,COPE-0914,3400740,6769,0,3393971
AAGGA,COPE-0610,4555604,15572,0,4540032
AGCTA,COPE-0804,249432,10710,0,238722
ACACA,COPE-0794,1586378,10863,0,1575515
AATTA,COPE-0654,2142920,6023,0,2136897
ACGGT,COPE-0825,301428,2977,0,298451
ACTGG,COPE-1005,892564,1565,0,890999
ACTTC,COPE-1102,285100,629,0,284471
ATACG,COPE-1220,423154,1065,0,422089
ATGAG,COPE-0838,129260,1151,0,128109
ATTAC,COPE-0967,3436612,10985,0,3425627
CATAT,COPE-0493,3702240,6450,0,3695790
CGAAT,COPE-0515,2920892,7673,0,2913219
CGGCT,COPE-1027,10275484,22594,0,10252890
CGGTA,COPE-0708,10548390,35572,0,10512818
CGTAC,COPE-0977,5716658,22933,0,5693725
CGTCG,COPE-0886,5307712,9820,0,5297892
CTGAT,COPE-0528,4999494,8078,0,4991416
CTGCG,COPE-0736,225048,1893,0,223155
CTGTC,COPE-0622,309290,1985,0,307305
CTTGG,COPE-0648,267712,810,0,266902
GACAC,COPE-0555,4388382,37304,0,4351078
GAGAT,COPE-1158,93708,983,0,92725
GAGTC,COPE-0606,312088,1978,0,310110
GCCGT,COPE-1260,610300,5628,0,604672
GCTGA,COPE-0774,321260,24490,0,296770
GGATA,COPE-1089,3196504,17393,0,3179111
GGCCA,COPE-0795,1467858,20391,0,1447467
GGCTC,COPE-1121,10847204,22666,0,10824538
GTAGT,COPE-1201,2697766,4597,0,2693169
GTCCG,COPE-0862,3632950,12093,0,3620857
GTCGA,COPE-1016,9752932,34463,0,9718469
TACCG,COPE-1144,2759734,11495,0,2748239
TACGT,COPE-1235,3536988,11392,0,3525596
TAGTA,COPE-0859,205618,6342,0,199276
TATAC,COPE-1055,1585828,3785,0,1582043
TCACG,COPE-0933,4456678,7497,0,4449181
TCAGT,COPE-1250,174894,4925,0,169969
TCCGG,COPE-0779,73146,20383,0,52763
TCTGC,COPE-0727,776866,2266,0,774600
TGGAA,COPE-1164,128632,5118,0,123514
TTACC,COPE-1181,132376,3030,0,129346
GCATG,COPE-0807,421954,1542,0,420412
AACCA,COPE-0569,1317892,10142,0,1307750
CGATC,COPE-0834,850952,5079,0,845873
TCGAT,COPE-0544,1158548,1578,0,1156970
TGCAT,COPE-0887,1041850,1214,0,1040636
CAACC,COPE-0547,2356518,2379,0,2354139
GGTTG,COPE-0906,463524,682,0,462842
AAGGA,COPE-1153,755788,4972,0,750816
AGCTA,COPE-0692,2772876,5893,0,2766983
ACACA,COPE-1195,954094,7457,0,946637
AATTA,COPE-0541,911020,2683,0,908337
ACGGT,COPE-0480,486690,1190,0,485500
ACTGG,COPE-0701,850570,1773,0,848797
ACTTC,COPE-0830,2372662,2595,0,2370067
ATACG,COPE-0792,248522,645,0,247877
ATGAG,COPE-1132,3400976,5630,0,3395346
ATTAC,COPE-0953,946004,2980,0,943024
CATAT,COPE-1025,841634,1215,0,840419
CGAAT,COPE-0512,3685518,4939,0,3680579
CGGCT,COPE-1084,1004792,2877,0,1001915
CGGTA,COPE-1258,584138,4349,0,579789
CGTAC,COPE-1124,1052622,1912,0,1050710
CGTCG,COPE-0658,1533998,1414,0,1532584
CTGAT,COPE-0776,1466010,2834,0,1463176
CTGCG,COPE-0917,706512,3304,0,703208
CTGTC,COPE-0603,1633068,6061,0,1627007
CTTGG,COPE-0604,728002,2053,0,725949
GACAC,COPE-1137,977678,4116,0,973562
GAGAT,COPE-0855,309916,982,0,308934
GAGTC,COPE-0740,586528,1710,0,584818
GCCGT,COPE-0764,654758,953,0,653805
GCTGA,COPE-0860,1610728,7260,0,1603468
GGATA,COPE-1109,474610,5092,0,469518
GGCCA,COPE-0998,1322634,4195,0,1318439
GGCTC,COPE-0520,574240,1075,0,573165
GTAGT,COPE-0628,39458,325,0,39133
GTCCG,COPE-0884,114968,608,0,114360
GTCGA,COPE-1263,581416,3452,0,577964
TACCG,COPE-1163,355780,1857,0,353923
TACGT,COPE-1129,968564,2684,0,965880
TAGTA,COPE-0646,734764,2546,0,732218
TATAC,COPE-0651,2633052,5279,0,2627773
TCACG,COPE-0501,1585146,3307,0,1581839
TCAGT,COPE-0905,365492,2341,0,363151
TCCGG,COPE-0839,47816,4927,0,42889
TCTGC,COPE-1133,3610,170,0,3440
TGGAA,COPE-0671,2137942,10134,0,2127808
TTACC,COPE-0742,2552826,7027,0,2545799
GCATG,COPE-0846,11593244,21449,0,11571795
AACCA,COPE-1106,8280526,81423,0,8199103
CGATC,COPE-0735,18633738,93158,0,18540580
TCGAT,COPE-1028,14439070,27654,0,14411416
TGCAT,COPE-1192,78960,3159,0,75801
CAACC,COPE-0940,18227026,32423,0,18194603
GGTTG,COPE-0582,26264548,36023,0,26228525
AAGGA,COPE-1229,67849752,333150,0,67516602
AGCTA,COPE-1088,1136476,27855,0,1108621
ACACA,COPE-0858,199988,8444,0,191544
AATTA,COPE-0749,10838564,32972,0,10805592
ACGGT,COPE-0978,1083258,8924,0,1074334
ACTGG,COPE-0835,436226,2993,0,433233
ACTTC,COPE-0600,10339802,14359,0,10325443
ATACG,COPE-1217,1403622,4653,0,1398969
ATGAG,COPE-0596,21747268,57057,0,21690211
ATTAC,COPE-1182,1393916,19108,0,1374808
CATAT,COPE-0474,12727282,25432,0,12701850
CGAAT,COPE-1261,16714674,39537,0,16675137
CGGCT,COPE-0907,24228656,66719,0,24161937
CGGTA,COPE-0782,19192920,115732,0,19077188
CGTAC,COPE-0777,101196,32832,0,68364
CGTCG,COPE-0499,30743982,41597,0,30702385
CTGAT,COPE-0883,34200844,83876,0,34116968
CTGCG,COPE-0938,4536228,11576,0,4524652
CTGTC,COPE-1052,219472,7688,0,211784
CTTGG,COPE-1059,16072126,45016,0,16027110
GACAC,COPE-0679,1482374,12241,0,1470133
GAGAT,COPE-0935,818128,8253,0,809875
GAGTC,COPE-0571,404316,5711,0,398605
GCCGT,COPE-0486,1955266,10155,0,1945111
GCTGA,COPE-1185,8376486,116978,0,8259508
GGATA,COPE-1097,30256478,91040,0,30165438
GGCCA,COPE-0640,15684392,77904,0,15606488
GGCTC,COPE-0772,12224198,34732,0,12189466
GTAGT,COPE-0529,8966684,15556,0,8951128
GTCCG,COPE-0560,9131768,31866,0,9099902
GTCGA,COPE-0614,11710984,89297,0,11621687
TACCG,COPE-0712,5067600,31693,0,5035907
TACGT,COPE-0475,11613270,21336,0,11591934
TAGTA,COPE-0503,1739184,20838,0,1718346
TATAC,COPE-0984,641606,5004,0,636602
TCACG,COPE-0540,971106,4435,0,966671
TCAGT,COPE-0817,670244,3780,0,666464
TCCGG,COPE-0957,397456,60069,0,337387
TCTGC,COPE-1013,673748,4079,0,669669
TGGAA,COPE-1172,6607654,72568,0,6535086
TTACC,COPE-0675,18175774,35991,0,18139783
GCATG,COPE-1193,1941976,5020,0,1936956
AACCA,COPE-0707,545508,8602,0,536906
CGATC,COPE-0500,1344258,11937,0,1332321
TCGAT,COPE-0986,134290,1787,0,132503
TGCAT,COPE-0881,3692,895,0,2797
CAACC,COPE-0673,2922340,3839,0,2918501
GGTTG,COPE-1012,1190448,3489,0,1186959
AAGGA,COPE-1196,6335534,48095,0,6287439
AGCTA,COPE-1078,1358596,12918,0,1345678
ACACA,COPE-1239,68252,7749,0,60503
AATTA,COPE-0950,1490514,5331,0,1485183
ACGGT,COPE-0889,11163462,17179,0,11146283
ACTGG,COPE-0629,3315908,8360,0,3307548
ACTTC,COPE-0691,21642,1310,0,20332
ATACG,COPE-0857,6104388,9832,0,6094556
ATGAG,COPE-1186,5935074,12518,0,5922556
ATTAC,COPE-1225,1346368,6386,0,1339982
CATAT,COPE-0578,571654,1628,0,570026
CGAAT,COPE-0623,6582660,6449,0,6576211
CGGCT,COPE-0992,5238378,9277,0,5229101
CGGTA,COPE-0880,215206,24348,0,190858
CGTAC,COPE-0959,7012,2178,0,4834
CGTCG,COPE-0617,2706274,3399,0,2702875
CTGAT,COPE-0587,6515298,15956,0,6499342
CTGCG,COPE-1101,1143258,8520,0,1134738
CTGTC,COPE-1141,3640704,9389,0,3631315
CTTGG,COPE-1148,3115496,10177,0,3105319
GACAC,COPE-0627,2988076,12131,0,2975945
GAGAT,COPE-0873,852436,3566,0,848870
GAGTC,COPE-1069,1384574,5060,0,1379514
GCCGT,COPE-1246,1784360,4862,0,1779498
GCTGA,COPE-0570,12242908,57269,0,12185639
GGATA,COPE-0575,4264764,18694,0,4246070
GGCCA,COPE-0814,7113856,35603,0,7078253
GGCTC,COPE-0566,3623612,8130,0,3615482
GTAGT,COPE-1264,4250652,7243,0,4243409
GTCCG,COPE-1000,1421384,4249,0,1417135
GTCGA,COPE-1123,1253502,14310,0,1239192
TACCG,COPE-1023,1241134,11606,0,1229528
TACGT,COPE-1058,4948138,15315,0,4932823
TAGTA,COPE-1085,2225224,16435,0,2208789
TATAC,COPE-0526,2300106,5904,0,2294202
TCACG,COPE-0898,2171332,5858,0,2165474
TCAGT,COPE-1010,6862354,11110,0,6851244
TCCGG,COPE-0946,115510,16705,0,98805
TCTGC,COPE-1090,2008348,3347,0,2005001
TGGAA,COPE-0869,2349324,11880,0,2337444
TTACC,COPE-0714,18896,1881,0,17015
GCATG,COPE-0488,4025378,12927,0,4012451
AACCA,COPE-1156,5932654,31164,0,5901490
CGATC,COPE-0738,5167626,13435,0,5154191
TCGAT,COPE-1038,2737382,6024,0,2731358
TGCAT,COPE-1251,5337658,6383,0,5331275
CAACC,COPE-0530,5513368,11306,0,5502062
GGTTG,COPE-1098,1539274,3658,0,1535616
AAGGA,COPE-1215,536578,6908,0,529670
AGCTA,COPE-0573,1138744,10613,0,1128131
ACACA,COPE-0913,1700596,17807,0,1682789
AATTA,COPE-1112,3831938,17472,0,3814466
ACGGT,COPE-0532,1359436,3355,0,1356081
ACTGG,COPE-1205,3785320,8749,0,3776571
ACTTC,COPE-1043,2625310,4733,0,2620577
ATACG,COPE-0769,3232364,5345,0,3227019
ATGAG,COPE-0820,683722,2291,0,681431
ATTAC,COPE-0552,1527876,11484,0,1516392
CATAT,COPE-1187,517222,1690,0,515532
CGAAT,COPE-0593,1321764,4630,0,1317134
CGGCT,COPE-0937,2214320,9179,0,2205141
CGGTA,COPE-0496,774590,16941,0,757649
CGTAC,COPE-0955,647124,3847,0,643277
CGTCG,COPE-0672,941464,4194,0,937270
CTGAT,COPE-0660,1844084,4419,0,1839665
CTGCG,COPE-0979,555016,9768,0,545248
CTGTC,COPE-0690,3095834,9841,0,3085993
CTTGG,COPE-1216,1961488,8327,0,1953161
GACAC,COPE-0864,3763552,17422,0,3746130
GAGAT,COPE-0681,1484548,4164,0,1480384
GAGTC,COPE-0918,3078220,10089,0,3068131
GCCGT,COPE-1045,2151104,3981,0,2147123
GCTGA,COPE-0780,721254,18198,0,703056
GGATA,COPE-0997,339252,10173,0,329079
GGCCA,COPE-1009,1855370,12141,0,1843229
GGCTC,COPE-0620,2401138,4912,0,2396226
GTAGT,COPE-1242,452742,2227,0,450515
GTCCG,COPE-0585,244922,2972,0,241950
GTCGA,COPE-0897,3177282,19028,0,3158254
TACCG,COPE-0786,836012,3644,0,832368
TACGT,COPE-1180,1088370,7974,0,1080396
TAGTA,COPE-0797,4142520,18617,0,4123903
TATAC,COPE-0856,1614130,8585,0,1605545
TCACG,COPE-1170,1815122,4538,0,1810584
TCAGT,COPE-0497,2129738,6059,0,2123679
TCCGG,COPE-0561,3317854,123675,0,3194179
TCTGC,COPE-0652,2059486,6735,0,2052751
TGGAA,COPE-0678,1762898,10538,0,1752360
TTACC,COPE-0581,7526,2657,0,4869
GCATG,COPE-0799,18797330,40494,0,18756836
AACCA,COPE-0677,11970948,59124,0,11911824
CGATC,COPE-1040,3229634,48873,0,3180761
TCGAT,COPE-1136,8775542,14244,0,8761298
TGCAT,COPE-0916,11235124,18565,0,11216559
CAACC,COPE-0920,9566040,15401,0,9550639
GGTTG,COPE-1046,12125874,24797,0,12101077
AAGGA,COPE-0565,22470528,94746,0,22375782
AGCTA,COPE-1116,5564926,31505,0,5533421
ACACA,COPE-0808,3826850,45716,0,3781134
AATTA,COPE-1171,3789630,26723,0,3762907
ACGGT,COPE-0746,6091818,12008,0,6079810
ACTGG,COPE-0980,9049066,22165,0,9026901
ACTTC,COPE-0936,6800804,11088,0,6789716
ATACG,COPE-0717,4673528,7502,0,4666026
ATGAG,COPE-1178,14937924,28687,0,14909237
ATTAC,COPE-1231,15729926,38351,0,15691575
CATAT,COPE-0705,17480170,23128,0,17457042
CGAAT,COPE-1131,6363726,19031,0,6344695
CGGCT,COPE-0682,8446280,38398,0,8407882
CGGTA,COPE-0948,7742658,102438,0,7640220
CGTAC,COPE-0931,17490330,47562,0,17442768
CGTCG,COPE-1063,11589586,26087,0,11563499
CTGAT,COPE-0476,14525796,21766,0,14504030
CTGCG,COPE-0755,13918530,24699,0,13893831
CTGTC,COPE-1120,722402,5962,0,716440
CTTGG,COPE-0954,489118,4340,0,484778
GACAC,COPE-0535,2552464,17755,0,2534709
GAGAT,COPE-1150,1028094,8844,0,1019250
GAGTC,COPE-1161,13161560,35146,0,13126414
GCCGT,COPE-0686,1498834,5540,0,1493294
GCTGA,COPE-0894,5665964,100975,0,5564989
GGATA,COPE-1128,10411876,56072,0,10355804
GGCCA,COPE-0784,2454830,18935,0,2435895
GGCTC,COPE-0847,352918,4464,0,348454
GTAGT,COPE-1111,5009594,12456,0,4997138
GTCCG,COPE-1062,1562560,6480,0,1556080
GTCGA,COPE-0741,3887464,47583,0,3839881
TACCG,COPE-0514,7043752,18633,0,7025119
TACGT,COPE-0815,1512010,24728,0,1487282
TAGTA,COPE-0910,399008,14057,0,384951
TATAC,COPE-0968,1091276,5067,0,1086209
TCACG,COPE-1157,1976156,5559,0,1970597
TCAGT,COPE-1105,4643602,9704,0,4633898
TCCGG,COPE-0656,951542,82691,0,868851
TCTGC,COPE-0590,12564,2131,0,10433
TGGAA,COPE-0903,4488186,39799,0,4448387
TTACC,COPE-0533,26782,13012,0,13770
GCATG,COPE-0934,41945234,71991,0,41873243
AACCA,COPE-0900,2709932,22573,0,2687359
CGATC,COPE-1081,5115020,51580,0,5063440
TCGAT,COPE-1266,1703830,5727,0,1698103
TGCAT,COPE-0538,2813020,8473,0,2804547
CAACC,COPE-1183,2869564,7599,0,2861965
GGTTG,COPE-1175,847310,2206,0,845104
AAGGA,COPE-1036,1348766,15951,0,1332815
AGCTA,COPE-1173,9186364,44861,0,9141503
ACACA,COPE-1070,2860648,31525,0,2829123
AATTA,COPE-0778,3467380,16416,0,3450964
ACGGT,COPE-0865,802730,3233,0,799497
ACTGG,COPE-0975,7542450,16463,0,7525987
ACTTC,COPE-0521,2332924,4628,0,2328296
ATACG,COPE-0589,8209762,12898,0,8196864
ATGAG,COPE-0762,3853994,12138,0,3841856
ATTAC,COPE-0469,1081798,10987,0,1070811
CATAT,COPE-0770,4699334,15385,0,4683949
CGAAT,COPE-0539,1871860,10024,0,1861836
CGGCT,COPE-1100,3953862,19242,0,3934620
CGGTA,COPE-1212,1531660,118726,0,1412934
CGTAC,COPE-0775,2687966,8641,0,2679325
CGTCG,COPE-0728,839166,3821,0,835345
CTGAT,COPE-0876,30059546,61706,0,29997840
CTGCG,COPE-0996,6331080,23512,0,6307568
CTGTC,COPE-1249,1944358,6892,0,1937466
CTTGG,COPE-0995,16686580,65632,0,16620948
GACAC,COPE-0983,6722788,32284,0,6690504
GAGAT,COPE-0726,7902170,16177,0,7885993
GAGTC,COPE-0801,24409482,44827,0,24364655
GCCGT,COPE-1237,2963478,9908,0,2953570
GCTGA,COPE-0531,3801692,90394,0,3711298
GGATA,COPE-0534,4115652,49404,0,4066248
GGCCA,COPE-0527,781364,13346,0,768018
GGCTC,COPE-1076,2110856,5387,0,2105469
GTAGT,COPE-0506,1986336,6554,0,1979782
GTCCG,COPE-0783,534636,4422,0,530214
GTCGA,COPE-0572,2515290,20295,0,2494995
TACCG,COPE-0659,656290,3669,0,652621
TACGT,COPE-1080,4224378,18588,0,4205790
TAGTA,COPE-1159,10025516,44105,0,9981411
TATAC,COPE-0985,5319606,21309,0,5298297
TCACG,COPE-0849,6745628,15164,0,6730464
TCAGT,COPE-0872,11921416,40726,0,11880690
TCCGG,COPE-1125,5875714,76312,0,5799402
TCTGC,COPE-0595,10022446,18365,0,10004081
TGGAA,COPE-0495,5366692,31358,0,5335334
TTACC,COPE-0641,33976,4774,0,29202
GCATG,COPE-1257,2696640,5129,0,2691511
AACCA,COPE-0765,10291836,55603,0,10236233
CGATC,COPE-0760,1002264,19274,0,982990
TCGAT,COPE-0577,1080060,9808,0,1070252
TGCAT,COPE-0863,1106000,1698,0,1104302
CAACC,COPE-1142,5878340,11471,0,5866869
GGTTG,COPE-0991,3613280,6423,0,3606857
AAGGA,COPE-1188,16379154,68762,0,16310392
AGCTA,COPE-0924,8875024,30587,0,8844437
ACACA,COPE-1065,408784,45165,0,363619
AATTA,COPE-0722,5203810,29244,0,5174566
ACGGT,COPE-0945,1576816,3278,0,1573538
ACTGG,COPE-0868,4863836,12236,0,4851600
ACTTC,COPE-0981,6137316,9442,0,6127874
ATACG,COPE-0667,6273052,11582,0,6261470
ATGAG,COPE-1224,4357248,10059,0,4347189
ATTAC,COPE-0866,33906232,52997,0,33853235
CATAT,COPE-0655,2239702,3864,0,2235838
CGAAT,COPE-1227,4862866,10148,0,4852718
CGGCT,COPE-0559,2132284,14808,0,2117476
CGGTA,COPE-0612,3549870,28862,0,3521008
CGTAC,COPE-0911,10518896,19058,0,10499838
CGTCG,COPE-0556,9963618,13048,0,9950570
CTGAT,COPE-1047,6770474,12469,0,6758005
CTGCG,COPE-1244,73532,6921,0,66611
CTGTC,COPE-0680,4069848,10511,0,4059337
CTTGG,COPE-0915,213730,1831,0,211899
GACAC,COPE-0548,808528,6756,0,801772
GAGAT,COPE-0492,3144682,8349,0,3136333
GAGTC,COPE-0927,435170,2868,0,432302
GCCGT,COPE-0643,1396278,4766,0,1391512
GCTGA,COPE-1037,1343840,27387,0,1316453
GGATA,COPE-1095,11514196,34775,0,11479421
GGCCA,COPE-0747,374998,3648,0,371350
GGCTC,COPE-1021,1117018,2919,0,1114099
GTAGT,COPE-0842,4525666,5418,0,4520248
GTCCG,COPE-0909,4979766,10280,0,4969486
GTCGA,COPE-1007,17463504,56548,0,17406956
TACCG,COPE-1114,3202050,10762,0,3191288
TACGT,COPE-1234,35200396,35537,0,35164859
TAGTA,COPE-1053,3267526,50693,0,3216833
TATAC,COPE-0568,220374,4945,0,215429
TCACG,COPE-0852,838804,1956,0,836848
TCAGT,COPE-1247,43264,1701,0,41563
TCCGG,COPE-0844,60068,24555,0,35513
TCTGC,COPE-0689,11650,346,0,11304
TGGAA,COPE-0893,1824252,23840,0,1800412
TTACC,COPE-0625,209460,20346,0,189114
GCATG,COPE-0704,1133066,4896,0,1128170
AACCA,COPE-1003,1858246,22544,0,1835702
CGATC,COPE-0537,2681548,16328,0,2665220
TCGAT,COPE-0731,2145708,7210,0,2138498
TGCAT,COPE-1004,2845044,2649,0,2842395
CAACC,COPE-0803,3494468,3747,0,3490721
GGTTG,COPE-0554,703050,1903,0,701147
AAGGA,COPE-0642,1624846,24222,0,1600624
AGCTA,COPE-0874,1078412,17666,0,1060746
ACACA,COPE-0982,8238518,47478,0,8191040
AATTA,COPE-0836,6662482,25590,0,6636892
ACGGT,COPE-0647,4094874,6303,0,4088571
ACTGG,COPE-0579,11005076,19127,0,10985949
ACTTC,COPE-0901,12594204,10864,0,12583340
ATACG,COPE-0607,10845666,15236,0,10830430
ATGAG,COPE-0508,10836314,19846,0,10816468
ATTAC,COPE-0882,3683900,20013,0,3663887
CATAT,COPE-0751,1420970,2623,0,1418347
CGAAT,COPE-0789,5580434,10121,0,5570313
CGGCT,COPE-0616,8823816,17799,0,8806017
CGGTA,COPE-1254,5057672,29712,0,5027960
CGTAC,COPE-1199,11303708,13468,0,11290240
CGTCG,COPE-1165,510036,3926,0,506110
CTGAT,COPE-0737,2566882,5054,0,2561828
CTGCG,COPE-0653,2060596,15355,0,2045241
CTGTC,COPE-0768,5186594,15844,0,5170750
CTTGG,COPE-1108,14255842,44906,0,14210936
GACAC,COPE-0949,1743410,8998,0,1734412
GAGAT,COPE-0518,760418,3578,0,756840
GAGTC,COPE-0611,11118790,13416,0,11105374
GCCGT,COPE-1048,12054460,12224,0,12042236
GCTGA,COPE-0802,132480,6865,0,125615
GGATA,COPE-1191,1931458,18342,0,1913116
GGCCA,COPE-1017,15664626,53863,0,15610763
GGCTC,COPE-0583,2207730,4659,0,2203071
GTAGT,COPE-1140,3461054,5474,0,3455580
GTCCG,COPE-0720,1429188,5351,0,1423837
GTCGA,COPE-0942,9947568,27780,0,9919788
TACCG,COPE-1034,4384480,9224,0,4375256
TACGT,COPE-1099,1231188,27760,0,1203428
TAGTA,COPE-1035,9967776,28171,0,9939605
TATAC,COPE-0734,7573544,20600,0,7552944
TCACG,COPE-0633,8378984,13311,0,8365673
TCAGT,COPE-1002,2471590,13736,0,2457854
TCCGG,COPE-0524,983460,57596,0,925864
TCTGC,COPE-0695,7005402,8169,0,6997233
TGGAA,COPE-0725,7032178,32092,0,7000086
TTACC,COPE-1083,19326,7309,0,12017
GCATG,COPE-0908,12200006,17140,0,12182866
AACCA,COPE-1093,4968158,29438,0,4938720
CGATC,COPE-0634,7297626,20087,0,7277539
TCGAT,COPE-0816,2517890,4212,0,2513678
TGCAT,COPE-0805,5377148,4664,0,5372484
CAACC,COPE-1049,4779290,4704,0,4774586
GGTTG,COPE-0730,2386478,4058,0,2382420
AAGGA,COPE-0494,3764606,14117,0,3750489
AGCTA,COPE-1240,2851562,19565,0,2831997
ACACA,COPE-0597,7015446,28398,0,6987048
AATTA,COPE-0507,5512268,17909,0,5494359
ACGGT,COPE-0867,4499440,6855,0,4492585
ACTGG,COPE-0732,3615644,8638,0,3607006
ACTTC,COPE-0545,1225502,1377,0,1224125
ATACG,COPE-1230,8479364,10728,0,8468636
ATGAG,COPE-0485,1304778,4478,0,1300300
ATTAC,COPE-1022,31142,10866,0,20276
CATAT,COPE-1087,3079160,3403,0,3075757
CGAAT,COPE-1032,5198378,10103,0,5188275
CGGCT,COPE-0791,9993042,25148,0,9967894
CGGTA,COPE-0602,4884508,34424,0,4850084
CGTAC,COPE-0895,7724288,13483,0,7710805
CGTCG,COPE-0482,9719382,10474,0,9708908
CTGAT,COPE-0965,3984846,12962,0,3971884
CTGCG,COPE-0543,6472220,17055,0,6455165
CTGTC,COPE-1152,6490002,8631,0,6481371
CTTGG,COPE-1051,3719570,10118,0,3709452
GACAC,COPE-0812,3146646,9760,0,3136886
GAGAT,COPE-1127,1602832,4019,0,1598813
GAGTC,COPE-0477,1712312,2555,0,1709757
GCCGT,COPE-0790,3776068,6406,0,3769662
GCTGA,COPE-1056,8316816,82218,0,8234598
GGATA,COPE-1211,11942752,25957,0,11916795
GGCCA,COPE-0973,11011692,28295,0,10983397
GGCTC,COPE-1139,4415046,5266,0,4409780
GTAGT,COPE-1145,5205658,5413,0,5200245
GTCCG,COPE-1054,1604666,3214,0,1601452
GTCGA,COPE-1044,1692354,28901,0,1663453
TACCG,COPE-0522,6300196,11614,0,6288582
TACGT,COPE-0613,8054864,23192,0,8031672
TAGTA,COPE-0925,5885578,25812,0,5859766
TATAC,COPE-1107,4711002,12085,0,4698917
TCACG,COPE-0516,1880,315,0,1565
TCAGT,COPE-0684,2980696,2570,0,2978126
TCCGG,COPE-0793,794632,60187,0,734445
TCTGC,COPE-0549,411124,1659,0,409465
TGGAA,COPE-1029,2047518,12659,0,2034859
TTACC,COPE-0861,697922,4539,0,693383
GCATG,COPE-0922,369548,13358,0,356190
AACCA,COPE-0618,9044620,38572,0,9006048
CGATC,COPE-0649,8054176,19537,0,8034639
TCGAT,COPE-0951,1185286,5059,0,1180227
TGCAT,COPE-0947,10825262,8333,0,10816929
CAACC,COPE-1207,9832614,8100,0,9824514
GGTTG,COPE-0670,303400,1061,0,302339
AAGGA,COPE-0669,650706,13401,0,637305
AGCTA,COPE-0713,4743904,31708,0,4712196
ACACA,COPE-1256,9644808,39181,0,9605627
AATTA,COPE-0739,5464936,21410,0,5443526
ACGGT,COPE-0970,8557400,11827,0,8545573
ACTGG,COPE-0879,13562018,28091,0,13533927
ACTTC,COPE-0818,11267004,8804,0,11258200
ATACG,COPE-0683,7021202,7859,0,7013343
ATGAG,Blank-1,729372,3218,0,726154
ATTAC,COPE-1179,5290270,22336,0,5267934
CATAT,COPE-0964,1940874,3273,0,1937601
CGAAT,COPE-1197,5249900,11779,0,5238121
CGGCT,COPE-0498,10976722,23888,0,10952834
CGGTA,COPE-0754,8269620,38561,0,8231059
CGTAC,COPE-1255,871708,13512,0,858196
CGTCG,COPE-1134,396974,4301,0,392673
CTGAT,COPE-0743,1967890,5484,0,1962406
CTGCG,COPE-0796,9424452,26630,0,9397822
CTGTC,COPE-0709,9747702,14057,0,9733645
CTTGG,COPE-1050,7398384,22946,0,7375438
GACAC,COPE-1110,7027242,19383,0,7007859
GAGAT,COPE-1166,4214730,6773,0,4207957
GAGTC,COPE-0890,2955486,4391,0,2951095
GCCGT,COPE-1074,6428996,8241,0,6420755
GCTGA,COPE-0845,379928,5632,0,374296
GGATA,COPE-0837,3604252,20297,0,3583955
GGCCA,COPE-0716,7032172,23818,0,7008354
GGCTC,COPE-0969,261228,1870,0,259358
GTAGT,COPE-0885,1900220,3847,0,1896373
GTCCG,COPE-0703,2586192,6840,0,2579352
GTCGA,COPE-0694,5252716,25748,0,5226968
TACCG,COPE-0702,7764464,13383,0,7751081
TACGT,COPE-1218,605414,24209,0,581205
TAGTA,COPE-0960,11732030,33055,0,11698975
TATAC,COPE-1039,3053002,15264,0,3037738
TCACG,COPE-0828,631578,1742,0,629836
TCAGT,COPE-1024,7529312,15096,0,7514216
TCCGG,COPE-1177,1327994,82437,0,1245557
TCTGC,COPE-0824,1384580,3124,0,1381456
TGGAA,COPE-1061,2486832,14796,0,2472036
TTACC,COPE-0574,15626,5162,0,10464
GCATG,COPE-0878,6956408,11225,0,6945183
AACCA,COPE-0941,7296694,24604,0,7272090
CGATC,COPE-0657,5919664,12025,0,5907639
TCGAT,COPE-0542,1628278,4068,0,1624210
TGCAT,COPE-0588,4114026,4680,0,4109346
CAACC,COPE-1014,4879140,5101,0,4874039
GGTTG,COPE-0638,4659886,7800,0,4652086
AAGGA,COPE-1030,5689436,19418,0,5670018
AGCTA,COPE-0718,5515120,17323,0,5497797
ACACA,COPE-0700,5785854,21660,0,5764194
AATTA,COPE-0809,4140430,17036,0,4123394
ACGGT,COPE-1122,4829820,3975,0,4825845
ACTGG,COPE-0932,4121012,7597,0,4113415
ACTTC,COPE-0752,5143136,3474,0,5139662
ATACG,COPE-0899,2815980,3935,0,2812045
ATGAG,Blank-2,1156180,2832,0,1153348
ATTAC,COPE-0479,3553644,12187,0,3541457
CATAT,COPE-0470,5483138,6442,0,5476696
CGAAT,COPE-0685,2089552,6105,0,2083447
CGGCT,COPE-0719,3482706,8648,0,3474058
CGGTA,COPE-0558,1205852,18009,0,1187843
CGTAC,COPE-0966,2548538,4637,0,2543901
CGTCG,COPE-0576,2555456,4428,0,2551028
CTGAT,COPE-0943,3008612,14355,0,2994257
CTGCG,COPE-1094,1139588,4284,0,1135304
CTGTC,COPE-0843,1518462,3444,0,1515018
CTTGG,COPE-1232,3474300,12233,0,3462067
GACAC,COPE-0888,2216864,8838,0,2208026
GAGAT,COPE-0944,2528880,4336,0,2524544
GAGTC,COPE-0798,2109842,4097,0,2105745
GCCGT,COPE-0729,3378422,6888,0,3371534
GCTGA,COPE-1041,1278824,26519,0,1252305
GGATA,COPE-0637,8313180,22069,0,8291111
GGCCA,COPE-1031,3336790,12483,0,3324307
GGCTC,COPE-0854,494420,1982,0,492438
GTAGT,COPE-1241,6005470,7284,0,5998186
GTCCG,COPE-1008,4212638,8156,0,4204482
GTCGA,COPE-0563,2620300,19462,0,2600838
TACCG,COPE-0674,8051022,19024,0,8031998
TACGT,COPE-0697,3065088,24525,0,3040563
TAGTA,COPE-1209,2370526,14456,0,2356070
TATAC,COPE-0478,1888842,4774,0,1884068
TCACG,COPE-0676,3880818,6179,0,3874639
TCAGT,COPE-0821,3942190,7973,0,3934217
TCCGG,COPE-0806,639628,77029,0,562599
TCTGC,COPE-0904,1226408,2261,0,1224147
TGGAA,COPE-0511,2906936,15846,0,2891090
TTACC,COPE-0564,9016,3699,0,5317
GCATG,COPE-0631,5946344,19794,0,5926550
AACCA,COPE-0963,2221468,18070,0,2203398
CGATC,COPE-1086,2415194,13194,0,2402000
TCGAT,COPE-1082,1688336,4037,0,1684299
TGCAT,COPE-0487,1569404,5684,0,1563720
CAACC,COPE-1033,2717890,8019,0,2709871
GGTTG,COPE-0484,3188272,10969,0,3177303
AAGGA,COPE-1060,9510792,48319,0,9462473
AGCTA,COPE-0800,5487502,43367,0,5444135
ACACA,COPE-0472,859362,12339,0,847023
AATTA,COPE-1204,410320,3892,0,406428
ACGGT,COPE-0489,311210,11394,0,299816
ACTGG,COPE-0745,318406,2475,0,315931
ACTTC,COPE-1162,496656,2008,0,494648
ATACG,COPE-1214,762062,3356,0,758706
ATGAG,COPE-0551,3411558,16620,0,3394938
ATTAC,COPE-1151,429150,2110,0,427040
CATAT,COPE-0698,424942,2547,0,422395
CGAAT,COPE-1113,470804,3434,0,467370
CGGCT,COPE-0553,398230,9790,0,388440
CGGTA,COPE-0811,766068,18761,0,747307
CGTAC,COPE-1228,980748,5561,0,975187
CGTCG,COPE-0598,76604,2458,0,74146
CTGAT,COPE-1213,723912,8671,0,715241
CTGCG,COPE-0990,6818738,22533,0,6796205
CTGTC,COPE-0706,3527130,14187,0,3512943
CTTGG,COPE-0491,5568756,25444,0,5543312
GACAC,COPE-1238,11470300,63289,0,11407011
GAGAT,COPE-0841,7600898,19397,0,7581501
GAGTC,COPE-0663,15460460,52524,0,15407936
GCCGT,COPE-1068,10058392,21105,0,10037287
GCTGA,COPE-0976,3748392,37753,0,3710639
