GCATG,COPE-0594,3779644,11745,0,3767899
AACCA,COPE-0848,7925244,31160,0,7894084
CGATC,COPE-0557,3007074,32053,0,2975021
TCGAT,COPE-1226,6304642,10890,0,6293752
TGCAT,COPE-1190,1625634,4524,0,1621110
CAACC,COPE-0902,3456242,11224,0,3445018
GGTTG,COPE-0788,19938034,17159,0,19920875
AAGGA,COPE-0831,26340408,89191,0,26251217
AGCTA,COPE-0666,184266,11261,0,173005
ACACA,COPE-1064,564926,9231,0,555695
AATTA,COPE-0833,21453682,66293,0,21387389
ACGGT,COPE-1006,1087144,4374,0,1082770
ACTGG,COPE-1265,1656854,6511,0,1650343
ACTTC,COPE-1202,3544752,6947,0,3537805
ATACG,COPE-0608,2489956,5403,0,2484553
ATGAG,COPE-1011,521424,2660,0,518764
ATTAC,COPE-1198,930116,34700,0,895416
CATAT,COPE-0632,709790,3039,0,706751
CGAAT,COPE-0687,644142,7239,0,636903
CGGCT,COPE-0763,10009846,32122,0,9977724
CGGTA,COPE-0599,265164,28492,0,236672
CGTAC,COPE-1073,7409510,20221,0,7389289
CGTCG,COPE-1176,2239846,7660,0,2232186
CTGAT,COPE-0481,8094998,22138,0,8072860
CTGCG,COPE-0562,54584,6110,0,48474
CTGTC,COPE-0605,509698,3377,0,506321
CTTGG,COPE-1155,2568088,9082,0,2559006
GACAC,COPE-1253,6780962,29092,0,6751870
GAGAT,COPE-0710,52226,1978,0,50248
GAGTC,COPE-1189,1010436,4129,0,1006307
GCCGT,COPE-0509,1063382,5282,0,1058100
GCTGA,COPE-0826,10342340,64542,0,10277798
GGATA,COPE-0810,362934,19700,0,343234
GGCCA,COPE-0592,3431418,18365,0,3413053
GGCTC,COPE-0829,588200,5598,0,582602
GTAGT,COPE-1118,1288008,3826,0,1284182
GTCCG,COPE-0580,656156,9750,0,646406
GTCGA,COPE-0766,2512624,14963,0,2497661
TACCG,COPE-0748,8788958,55243,0,8733715
TACGT,COPE-0758,8686340,24949,0,8661391
TAGTA,COPE-0635,480362,10179,0,470183
TATAC,COPE-0715,529966,2857,0,527109
TCACG,COPE-0473,858910,6538,0,852372
TCAGT,COPE-0896,77398,1999,0,75399
TCCGG,COPE-1077,195316,52991,0,142325
TCTGC,COPE-1168,6052478,16321,0,6036157
TGGAA,COPE-0921,9087204,55911,0,9031293
TTACC,COPE-0513,12748,2451,0,10297
