GCATG,COPE-0711,5266826,18129,0,5248697
AACCA,COPE-1233,5770012,412981,0,5357031
CGATC,COPE-0929,4404866,78014,0,4326852
TCGAT,COPE-0773,4253428,8369,0,4245059
TGCAT,COPE-1135,3999014,8024,0,3990990
CAACC,COPE-1248,5726034,52430,0,5673604
GGTTG,COPE-0956,7590574,13671,0,7576903
AAGGA,COPE-0993,3111738,22423,0,3089315
AGCTA,COPE-0757,2872314,19645,0,2852669
ACACA,COPE-0630,7117684,43468,0,7074216
AATTA,COPE-0586,1936498,9857,0,1926641
ACGGT,COPE-0615,3022912,12547,0,3010365
ACTGG,COPE-0510,6651100,32249,0,6618851
ACTTC,COPE-1203,5409496,14084,0,5395412
ATACG,COPE-1138,11613714,20274,0,11593440
ATGAG,COPE-1210,6983838,18338,0,6965500
ATTAC,COPE-0523,616704,10874,0,605830
CATAT,COPE-1020,3641088,10897,0,3630191
CGAAT,COPE-1096,1987432,14729,0,1972703
CGGCT,COPE-0550,1234010,29251,0,1204759
CGGTA,COPE-0483,5181282,53243,0,5128039
CGTAC,COPE-1015,9973474,184463,0,9789011
CGTCG,COPE-0721,3980960,17268,0,3963692
CTGAT,COPE-0823,2163532,10475,0,2153057
CTGCG,COPE-1200,871706,10374,0,861332
CTGTC,COPE-0502,53962,2915,0,51047
CTTGG,COPE-0785,8211452,30268,0,8181184
GACAC,COPE-0662,4632622,41024,0,4591598
GAGAT,COPE-0961,4129228,18736,0,4110492
GAGTC,COPE-0519,1494452,6063,0,1488389
GCCGT,COPE-1042,10686816,16422,0,10670394
GCTGA,COPE-1117,6071398,46474,0,6024924
GGATA,COPE-0750,3016976,29581,0,2987395
GGCCA,COPE-1019,6770270,25954,0,6744316
GGCTC,COPE-0761,424654,4457,0,420197
GTAGT,COPE-0787,560734,3528,0,557206
GTCCG,COPE-0626,1217416,8216,0,1209200
GTCGA,COPE-0546,2393246,21343,0,2371903
TACCG,COPE-0827,49698,5699,0,43999
TACGT,COPE-0536,1055708,12425,0,1043283
TAGTA,COPE-0619,1795390,15949,0,1779441
TATAC,COPE-0601,5704792,18086,0,5686706
TCACG,COPE-1222,1968290,12524,0,1955766
TCAGT,COPE-0744,14809106,24710,0,14784396
TCCGG,COPE-1092,480596,29781,0,450815
TCTGC,COPE-0636,4547470,23346,0,4524124
TGGAA,COPE-0661,15234792,60492,0,15174300
TTACC,COPE-0699,24548504,59893,0,24488611
