GCATG,COPE-0994,5988274,24091,0,5964183
AACCA,COPE-0926,10224780,43318,0,10181462
CGATC,COPE-0645,11314638,40870,0,11273768
TCGAT,COPE-0958,9452276,13849,0,9438427
TGCAT,COPE-1115,11641042,16751,0,11624291
CAACC,COPE-1075,8556084,15653,0,8540431
GGTTG,COPE-0962,2131290,3988,0,2127302
AAGGA,COPE-1146,12681420,48510,0,12632910
AGCTA,COPE-1219,4219594,24215,0,4195379
ACACA,COPE-0871,3566576,16295,0,3550281
AATTA,COPE-0850,1196848,5984,0,1190864
ACGGT,COPE-0624,3695550,9045,0,3686505
ACTGG,COPE-1245,7536284,10115,0,7526169
ACTTC,COPE-0723,5310862,5327,0,5305535
ATACG,COPE-1206,3334118,4225,0,3329893
ATGAG,COPE-0517,6396432,28359,0,6368073
ATTAC,COPE-1026,3249642,11320,0,3238322
CATAT,COPE-0525,7234224,14806,0,7219418
CGAAT,COPE-1259,6737678,12227,0,6725451
CGGCT,COPE-0840,5392578,18463,0,5374115
CGGTA,COPE-0639,9605282,43103,0,9562179
CGTAC,COPE-0919,4746360,17656,0,4728704
CGTCG,COPE-1143,3427216,7414,0,3419802
CTGAT,COPE-1160,9399112,16303,0,9382809
CTGCG,COPE-0505,5184346,11926,0,5172420
CTGTC,COPE-1130,1236930,4758,0,1232172
CTTGG,COPE-1236,2057184,6012,0,2051172
GACAC,COPE-0989,4053988,11934,0,4042054
GAGAT,COPE-0870,7827828,19272,0,7808556
GAGTC,COPE-1208,3357630,6602,0,3351028
GCCGT,COPE-0756,5134060,11686,0,5122374
GCTGA,COPE-0771,3879866,31606,0,3848260
GGATA,COPE-0891,4552488,31219,0,4521269
GGCCA,COPE-0621,3730640,25170,0,3705470
GGCTC,COPE-0650,8041440,14903,0,8026537
GTAGT,COPE-0813,3635020,6300,0,3628720
GTCCG,COPE-0822,9310834,15882,0,9294952
GTCGA,COPE-1147,123274,24115,0,99159
TACCG,COPE-0724,410596,6148,0,404448
TACGT,COPE-0471,3878008,8219,0,3869789
TAGTA,COPE-1184,5773468,17264,0,5756204
TATAC,COPE-0875,104406,6094,0,98312
TCACG,COPE-0877,916796,1685,0,915111
TCAGT,COPE-0952,6154116,6608,0,6147508
TCCGG,COPE-1018,1068258,20409,0,1047849
TCTGC,COPE-1071,1631140,4380,0,1626760
TGGAA,COPE-1104,198570,13676,0,184894
TTACC,COPE-0609,10558,1866,0,8692
