GCATG,COPE-0767,4333810,17809,0,4316001
AACCA,COPE-0490,130796,20628,0,110168
CGATC,COPE-1252,4922430,30115,0,4892315
TCGAT,COPE-0753,5385998,7027,0,5378971
TGCAT,COPE-1221,7854418,9181,0,7845237
CAACC,COPE-1167,10342266,19154,0,10323112
GGTTG,COPE-0999,5847992,8231,0,5839761
AAGGA,COPE-1103,14412186,56727,0,14355459
AGCTA,COPE-1223,1903902,30968,0,1872934
ACACA,COPE-1067,989752,25606,0,964146
AATTA,COPE-0930,3120066,9977,0,3110089
ACGGT,COPE-0664,5568238,11171,0,5557067
ACTGG,COPE-1243,4491322,13279,0,4478043
ACTTC,COPE-0928,5685964,8500,0,5677464
ATACG,COPE-1079,13290022,19788,0,13270234
ATGAG,COPE-1169,15701628,28405,0,15673223
ATTAC,COPE-1091,1126634,10152,0,1116482
CATAT,COPE-1149,2763084,6432,0,2756652
CGAAT,COPE-0644,1600862,6794,0,1594068
CGGCT,COPE-0781,521828,14196,0,507632
CGGTA,COPE-0912,5061328,44927,0,5016401
CGTAC,COPE-0759,4478220,10538,0,4467682
CGTCG,COPE-0974,4366280,5148,0,4361132
CTGAT,COPE-1194,13220906,36590,0,13184316
CTGCG,COPE-0665,3083620,25422,0,3058198
CTGTC,COPE-0688,4082564,10173,0,4072391
CTTGG,COPE-0832,124404,1570,0,122834
GACAC,COPE-1126,14650192,49423,0,14600769
GAGAT,COPE-1072,13505006,34420,0,13470586
GAGTC,COPE-0696,6602364,16628,0,6585736
GCCGT,COPE-1001,5323256,11818,0,5311438
GCTGA,COPE-0584,22231334,93501,0,22137833
GGATA,COPE-0504,4842354,45295,0,4797059
GGCCA,COPE-0567,4095910,13926,0,4081984
GGCTC,COPE-0668,991268,3273,0,987995
GTAGT,COPE-0892,5977624,6455,0,5971169
GTCCG,COPE-0853,3223834,6785,0,3217049
GTCGA,COPE-0693,2906084,27250,0,2878834
TACCG,COPE-0819,3737142,12810,0,3724332
TACGT,COPE-1262,42896,16479,0,26417
TAGTA,COPE-0591,2779428,9439,0,2769989
TATAC,COPE-1174,7621908,17102,0,7604806
TCACG,COPE-0923,561826,9408,0,552418
TCAGT,COPE-1066,54380,2084,0,52296
TCCGG,COPE-0733,55306,20797,0,34509
TCTGC,COPE-0987,16982408,51641,0,16930767
TGGAA,COPE-0971,9847880,39521,0,9808359
TTACC,COPE-1057,9086,4161,0,4925
