GCATG,COPE-0939,6945404,14933,0,6930471
AACCA,COPE-1119,9288368,36373,0,9251995
CGATC,COPE-0988,6291494,30611,0,6260883
TCGAT,COPE-1154,10459514,13766,0,10445748
TGCAT,COPE-0972,4422708,6263,0,4416445
CAACC,COPE-0851,8570622,17871,0,8552751
GGTTG,COPE-0914,3400740,6769,0,3393971
AAGGA,COPE-0610,4555604,15572,0,4540032
AGCTA,COPE-0804,249432,10710,0,238722
ACACA,COPE-0794,1586378,10863,0,1575515
AATTA,COPE-0654,2142920,6023,0,2136897
ACGGT,COPE-0825,301428,2977,0,298451
ACTGG,COPE-1005,892564,1565,0,890999
ACTTC,COPE-1102,285100,629,0,284471
ATACG,COPE-1220,423154,1065,0,422089
ATGAG,COPE-0838,129260,1151,0,128109
ATTAC,COPE-0967,3436612,10985,0,3425627
CATAT,COPE-0493,3702240,6450,0,3695790
CGAAT,COPE-0515,2920892,7673,0,2913219
CGGCT,COPE-1027,10275484,22594,0,10252890
CGGTA,COPE-0708,10548390,35572,0,10512818
CGTAC,COPE-0977,5716658,22933,0,5693725
CGTCG,COPE-0886,5307712,9820,0,5297892
CTGAT,COPE-0528,4999494,8078,0,4991416
CTGCG,COPE-0736,225048,1893,0,223155
CTGTC,COPE-0622,309290,1985,0,307305
CTTGG,COPE-0648,267712,810,0,266902
GACAC,COPE-0555,4388382,37304,0,4351078
GAGAT,COPE-1158,93708,983,0,92725
GAGTC,COPE-0606,312088,1978,0,310110
GCCGT,COPE-1260,610300,5628,0,604672
GCTGA,COPE-0774,321260,24490,0,296770
GGATA,COPE-1089,3196504,17393,0,3179111
GGCCA,COPE-0795,1467858,20391,0,1447467
GGCTC,COPE-1121,10847204,22666,0,10824538
GTAGT,COPE-1201,2697766,4597,0,2693169
GTCCG,COPE-0862,3632950,12093,0,3620857
GTCGA,COPE-1016,9752932,34463,0,9718469
TACCG,COPE-1144,2759734,11495,0,2748239
TACGT,COPE-1235,3536988,11392,0,3525596
TAGTA,COPE-0859,205618,6342,0,199276
TATAC,COPE-1055,1585828,3785,0,1582043
TCACG,COPE-0933,4456678,7497,0,4449181
TCAGT,COPE-1250,174894,4925,0,169969
TCCGG,COPE-0779,73146,20383,0,52763
TCTGC,COPE-0727,776866,2266,0,774600
TGGAA,COPE-1164,128632,5118,0,123514
TTACC,COPE-1181,132376,3030,0,129346
