GCATG,COPE-0807,421954,1542,0,420412
AACCA,COPE-0569,1317892,10142,0,1307750
CGATC,COPE-0834,850952,5079,0,845873
TCGAT,COPE-0544,1158548,1578,0,1156970
TGCAT,COPE-0887,1041850,1214,0,1040636
CAACC,COPE-0547,2356518,2379,0,2354139
GGTTG,COPE-0906,463524,682,0,462842
AAGGA,COPE-1153,755788,4972,0,750816
AGCTA,COPE-0692,2772876,5893,0,2766983
ACACA,COPE-1195,954094,7457,0,946637
AATTA,COPE-0541,911020,2683,0,908337
ACGGT,COPE-0480,486690,1190,0,485500
ACTGG,COPE-0701,850570,1773,0,848797
ACTTC,COPE-0830,2372662,2595,0,2370067
ATACG,COPE-0792,248522,645,0,247877
ATGAG,COPE-1132,3400976,5630,0,3395346
ATTAC,COPE-0953,946004,2980,0,943024
CATAT,COPE-1025,841634,1215,0,840419
CGAAT,COPE-0512,3685518,4939,0,3680579
CGGCT,COPE-1084,1004792,2877,0,1001915
CGGTA,COPE-1258,584138,4349,0,579789
CGTAC,COPE-1124,1052622,1912,0,1050710
CGTCG,COPE-0658,1533998,1414,0,1532584
CTGAT,COPE-0776,1466010,2834,0,1463176
CTGCG,COPE-0917,706512,3304,0,703208
CTGTC,COPE-0603,1633068,6061,0,1627007
CTTGG,COPE-0604,728002,2053,0,725949
GACAC,COPE-1137,977678,4116,0,973562
GAGAT,COPE-0855,309916,982,0,308934
GAGTC,COPE-0740,586528,1710,0,584818
GCCGT,COPE-0764,654758,953,0,653805
GCTGA,COPE-0860,1610728,7260,0,1603468
GGATA,COPE-1109,474610,5092,0,469518
GGCCA,COPE-0998,1322634,4195,0,1318439
GGCTC,COPE-0520,574240,1075,0,573165
GTAGT,COPE-0628,39458,325,0,39133
GTCCG,COPE-0884,114968,608,0,114360
GTCGA,COPE-1263,581416,3452,0,577964
TACCG,COPE-1163,355780,1857,0,353923
TACGT,COPE-1129,968564,2684,0,965880
TAGTA,COPE-0646,734764,2546,0,732218
TATAC,COPE-0651,2633052,5279,0,2627773
TCACG,COPE-0501,1585146,3307,0,1581839
TCAGT,COPE-0905,365492,2341,0,363151
TCCGG,COPE-0839,47816,4927,0,42889
TCTGC,COPE-1133,3610,170,0,3440
TGGAA,COPE-0671,2137942,10134,0,2127808
TTACC,COPE-0742,2552826,7027,0,2545799
