GCATG,COPE-0846,11593244,21449,0,11571795
AACCA,COPE-1106,8280526,81423,0,8199103
CGATC,COPE-0735,18633738,93158,0,18540580
TCGAT,COPE-1028,14439070,27654,0,14411416
TGCAT,COPE-1192,78960,3159,0,75801
CAACC,COPE-0940,18227026,32423,0,18194603
GGTTG,COPE-0582,26264548,36023,0,26228525
AAGGA,COPE-1229,67849752,333150,0,67516602
AGCTA,COPE-1088,1136476,27855,0,1108621
ACACA,COPE-0858,199988,8444,0,191544
AATTA,COPE-0749,10838564,32972,0,10805592
ACGGT,COPE-0978,1083258,8924,0,1074334
ACTGG,COPE-0835,436226,2993,0,433233
ACTTC,COPE-0600,10339802,14359,0,10325443
ATACG,COPE-1217,1403622,4653,0,1398969
ATGAG,COPE-0596,21747268,57057,0,21690211
ATTAC,COPE-1182,1393916,19108,0,1374808
CATAT,COPE-0474,12727282,25432,0,12701850
CGAAT,COPE-1261,16714674,39537,0,16675137
CGGCT,COPE-0907,24228656,66719,0,24161937
CGGTA,COPE-0782,19192920,115732,0,19077188
CGTAC,COPE-0777,101196,32832,0,68364
CGTCG,COPE-0499,30743982,41597,0,30702385
CTGAT,COPE-0883,34200844,83876,0,34116968
CTGCG,COPE-0938,4536228,11576,0,4524652
CTGTC,COPE-1052,219472,7688,0,211784
CTTGG,COPE-1059,16072126,45016,0,16027110
GACAC,COPE-0679,1482374,12241,0,1470133
GAGAT,COPE-0935,818128,8253,0,809875
GAGTC,COPE-0571,404316,5711,0,398605
GCCGT,COPE-0486,1955266,10155,0,1945111
GCTGA,COPE-1185,8376486,116978,0,8259508
GGATA,COPE-1097,30256478,91040,0,30165438
GGCCA,COPE-0640,15684392,77904,0,15606488
GGCTC,COPE-0772,12224198,34732,0,12189466
GTAGT,COPE-0529,8966684,15556,0,8951128
GTCCG,COPE-0560,9131768,31866,0,9099902
GTCGA,COPE-0614,11710984,89297,0,11621687
TACCG,COPE-0712,5067600,31693,0,5035907
TACGT,COPE-0475,11613270,21336,0,11591934
TAGTA,COPE-0503,1739184,20838,0,1718346
TATAC,COPE-0984,641606,5004,0,636602
TCACG,COPE-0540,971106,4435,0,966671
TCAGT,COPE-0817,670244,3780,0,666464
TCCGG,COPE-0957,397456,60069,0,337387
TCTGC,COPE-1013,673748,4079,0,669669
TGGAA,COPE-1172,6607654,72568,0,6535086
TTACC,COPE-0675,18175774,35991,0,18139783
