GCATG,COPE-1193,1941976,5020,0,1936956
AACCA,COPE-0707,545508,8602,0,536906
CGATC,COPE-0500,1344258,11937,0,1332321
TCGAT,COPE-0986,134290,1787,0,132503
TGCAT,COPE-0881,3692,895,0,2797
CAACC,COPE-0673,2922340,3839,0,2918501
GGTTG,COPE-1012,1190448,3489,0,1186959
AAGGA,COPE-1196,6335534,48095,0,6287439
AGCTA,COPE-1078,1358596,12918,0,1345678
ACACA,COPE-1239,68252,7749,0,60503
AATTA,COPE-0950,1490514,5331,0,1485183
ACGGT,COPE-0889,11163462,17179,0,11146283
ACTGG,COPE-0629,3315908,8360,0,3307548
ACTTC,COPE-0691,21642,1310,0,20332
ATACG,COPE-0857,6104388,9832,0,6094556
ATGAG,COPE-1186,5935074,12518,0,5922556
ATTAC,COPE-1225,1346368,6386,0,1339982
CATAT,COPE-0578,571654,1628,0,570026
CGAAT,COPE-0623,6582660,6449,0,6576211
CGGCT,COPE-0992,5238378,9277,0,5229101
CGGTA,COPE-0880,215206,24348,0,190858
CGTAC,COPE-0959,7012,2178,0,4834
CGTCG,COPE-0617,2706274,3399,0,2702875
CTGAT,COPE-0587,6515298,15956,0,6499342
CTGCG,COPE-1101,1143258,8520,0,1134738
CTGTC,COPE-1141,3640704,9389,0,3631315
CTTGG,COPE-1148,3115496,10177,0,3105319
GACAC,COPE-0627,2988076,12131,0,2975945
GAGAT,COPE-0873,852436,3566,0,848870
GAGTC,COPE-1069,1384574,5060,0,1379514
GCCGT,COPE-1246,1784360,4862,0,1779498
GCTGA,COPE-0570,12242908,57269,0,12185639
GGATA,COPE-0575,4264764,18694,0,4246070
GGCCA,COPE-0814,7113856,35603,0,7078253
GGCTC,COPE-0566,3623612,8130,0,3615482
GTAGT,COPE-1264,4250652,7243,0,4243409
GTCCG,COPE-1000,1421384,4249,0,1417135
GTCGA,COPE-1123,1253502,14310,0,1239192
TACCG,COPE-1023,1241134,11606,0,1229528
TACGT,COPE-1058,4948138,15315,0,4932823
TAGTA,COPE-1085,2225224,16435,0,2208789
TATAC,COPE-0526,2300106,5904,0,2294202
TCACG,COPE-0898,2171332,5858,0,2165474
TCAGT,COPE-1010,6862354,11110,0,6851244
TCCGG,COPE-0946,115510,16705,0,98805
TCTGC,COPE-1090,2008348,3347,0,2005001
TGGAA,COPE-0869,2349324,11880,0,2337444
TTACC,COPE-0714,18896,1881,0,17015
