GCATG,COPE-0488,4025378,12927,0,4012451
AACCA,COPE-1156,5932654,31164,0,5901490
CGATC,COPE-0738,5167626,13435,0,5154191
TCGAT,COPE-1038,2737382,6024,0,2731358
TGCAT,COPE-1251,5337658,6383,0,5331275
CAACC,COPE-0530,5513368,11306,0,5502062
GGTTG,COPE-1098,1539274,3658,0,1535616
AAGGA,COPE-1215,536578,6908,0,529670
AGCTA,COPE-0573,1138744,10613,0,1128131
ACACA,COPE-0913,1700596,17807,0,1682789
AATTA,COPE-1112,3831938,17472,0,3814466
ACGGT,COPE-0532,1359436,3355,0,1356081
ACTGG,COPE-1205,3785320,8749,0,3776571
ACTTC,COPE-1043,2625310,4733,0,2620577
ATACG,COPE-0769,3232364,5345,0,3227019
ATGAG,COPE-0820,683722,2291,0,681431
ATTAC,COPE-0552,1527876,11484,0,1516392
CATAT,COPE-1187,517222,1690,0,515532
CGAAT,COPE-0593,1321764,4630,0,1317134
CGGCT,COPE-0937,2214320,9179,0,2205141
CGGTA,COPE-0496,774590,16941,0,757649
CGTAC,COPE-0955,647124,3847,0,643277
CGTCG,COPE-0672,941464,4194,0,937270
CTGAT,COPE-0660,1844084,4419,0,1839665
CTGCG,COPE-0979,555016,9768,0,545248
CTGTC,COPE-0690,3095834,9841,0,3085993
CTTGG,COPE-1216,1961488,8327,0,1953161
GACAC,COPE-0864,3763552,17422,0,3746130
GAGAT,COPE-0681,1484548,4164,0,1480384
GAGTC,COPE-0918,3078220,10089,0,3068131
GCCGT,COPE-1045,2151104,3981,0,2147123
GCTGA,COPE-0780,721254,18198,0,703056
GGATA,COPE-0997,339252,10173,0,329079
GGCCA,COPE-1009,1855370,12141,0,1843229
GGCTC,COPE-0620,2401138,4912,0,2396226
GTAGT,COPE-1242,452742,2227,0,450515
GTCCG,COPE-0585,244922,2972,0,241950
GTCGA,COPE-0897,3177282,19028,0,3158254
TACCG,COPE-0786,836012,3644,0,832368
TACGT,COPE-1180,1088370,7974,0,1080396
TAGTA,COPE-0797,4142520,18617,0,4123903
TATAC,COPE-0856,1614130,8585,0,1605545
TCACG,COPE-1170,1815122,4538,0,1810584
TCAGT,COPE-0497,2129738,6059,0,2123679
TCCGG,COPE-0561,3317854,123675,0,3194179
TCTGC,COPE-0652,2059486,6735,0,2052751
TGGAA,COPE-0678,1762898,10538,0,1752360
TTACC,COPE-0581,7526,2657,0,4869
