GCATG,COPE-0799,18797330,40494,0,18756836
AACCA,COPE-0677,11970948,59124,0,11911824
CGATC,COPE-1040,3229634,48873,0,3180761
TCGAT,COPE-1136,8775542,14244,0,8761298
TGCAT,COPE-0916,11235124,18565,0,11216559
CAACC,COPE-0920,9566040,15401,0,9550639
GGTTG,COPE-1046,12125874,24797,0,12101077
AAGGA,COPE-0565,22470528,94746,0,22375782
AGCTA,COPE-1116,5564926,31505,0,5533421
ACACA,COPE-0808,3826850,45716,0,3781134
AATTA,COPE-1171,3789630,26723,0,3762907
ACGGT,COPE-0746,6091818,12008,0,6079810
ACTGG,COPE-0980,9049066,22165,0,9026901
ACTTC,COPE-0936,6800804,11088,0,6789716
ATACG,COPE-0717,4673528,7502,0,4666026
ATGAG,COPE-1178,14937924,28687,0,14909237
ATTAC,COPE-1231,15729926,38351,0,15691575
CATAT,COPE-0705,17480170,23128,0,17457042
CGAAT,COPE-1131,6363726,19031,0,6344695
CGGCT,COPE-0682,8446280,38398,0,8407882
CGGTA,COPE-0948,7742658,102438,0,7640220
CGTAC,COPE-0931,17490330,47562,0,17442768
CGTCG,COPE-1063,11589586,26087,0,11563499
CTGAT,COPE-0476,14525796,21766,0,14504030
CTGCG,COPE-0755,13918530,24699,0,13893831
CTGTC,COPE-1120,722402,5962,0,716440
CTTGG,COPE-0954,489118,4340,0,484778
GACAC,COPE-0535,2552464,17755,0,2534709
GAGAT,COPE-1150,1028094,8844,0,1019250
GAGTC,COPE-1161,13161560,35146,0,13126414
GCCGT,COPE-0686,1498834,5540,0,1493294
GCTGA,COPE-0894,5665964,100975,0,5564989
GGATA,COPE-1128,10411876,56072,0,10355804
GGCCA,COPE-0784,2454830,18935,0,2435895
GGCTC,COPE-0847,352918,4464,0,348454
GTAGT,COPE-1111,5009594,12456,0,4997138
GTCCG,COPE-1062,1562560,6480,0,1556080
GTCGA,COPE-0741,3887464,47583,0,3839881
TACCG,COPE-0514,7043752,18633,0,7025119
TACGT,COPE-0815,1512010,24728,0,1487282
TAGTA,COPE-0910,399008,14057,0,384951
TATAC,COPE-0968,1091276,5067,0,1086209
TCACG,COPE-1157,1976156,5559,0,1970597
TCAGT,COPE-1105,4643602,9704,0,4633898
TCCGG,COPE-0656,951542,82691,0,868851
TCTGC,COPE-0590,12564,2131,0,10433
TGGAA,COPE-0903,4488186,39799,0,4448387
TTACC,COPE-0533,26782,13012,0,13770
