GCATG,COPE-0934,41945234,71991,0,41873243
AACCA,COPE-0900,2709932,22573,0,2687359
CGATC,COPE-1081,5115020,51580,0,5063440
TCGAT,COPE-1266,1703830,5727,0,1698103
TGCAT,COPE-0538,2813020,8473,0,2804547
CAACC,COPE-1183,2869564,7599,0,2861965
GGTTG,COPE-1175,847310,2206,0,845104
AAGGA,COPE-1036,1348766,15951,0,1332815
AGCTA,COPE-1173,9186364,44861,0,9141503
ACACA,COPE-1070,2860648,31525,0,2829123
AATTA,COPE-0778,3467380,16416,0,3450964
ACGGT,COPE-0865,802730,3233,0,799497
ACTGG,COPE-0975,7542450,16463,0,7525987
ACTTC,COPE-0521,2332924,4628,0,2328296
ATACG,COPE-0589,8209762,12898,0,8196864
ATGAG,COPE-0762,3853994,12138,0,3841856
ATTAC,COPE-0469,1081798,10987,0,1070811
CATAT,COPE-0770,4699334,15385,0,4683949
CGAAT,COPE-0539,1871860,10024,0,1861836
CGGCT,COPE-1100,3953862,19242,0,3934620
CGGTA,COPE-1212,1531660,118726,0,1412934
CGTAC,COPE-0775,2687966,8641,0,2679325
CGTCG,COPE-0728,839166,3821,0,835345
CTGAT,COPE-0876,30059546,61706,0,29997840
CTGCG,COPE-0996,6331080,23512,0,6307568
CTGTC,COPE-1249,1944358,6892,0,1937466
CTTGG,COPE-0995,16686580,65632,0,16620948
GACAC,COPE-0983,6722788,32284,0,6690504
GAGAT,COPE-0726,7902170,16177,0,7885993
GAGTC,COPE-0801,24409482,44827,0,24364655
GCCGT,COPE-1237,2963478,9908,0,2953570
GCTGA,COPE-0531,3801692,90394,0,3711298
GGATA,COPE-0534,4115652,49404,0,4066248
GGCCA,COPE-0527,781364,13346,0,768018
GGCTC,COPE-1076,2110856,5387,0,2105469
GTAGT,COPE-0506,1986336,6554,0,1979782
GTCCG,COPE-0783,534636,4422,0,530214
GTCGA,COPE-0572,2515290,20295,0,2494995
TACCG,COPE-0659,656290,3669,0,652621
TACGT,COPE-1080,4224378,18588,0,4205790
TAGTA,COPE-1159,10025516,44105,0,9981411
TATAC,COPE-0985,5319606,21309,0,5298297
TCACG,COPE-0849,6745628,15164,0,6730464
TCAGT,COPE-0872,11921416,40726,0,11880690
TCCGG,COPE-1125,5875714,76312,0,5799402
TCTGC,COPE-0595,10022446,18365,0,10004081
TGGAA,COPE-0495,5366692,31358,0,5335334
TTACC,COPE-0641,33976,4774,0,29202
