GCATG,COPE-1257,2696640,5129,0,2691511
AACCA,COPE-0765,10291836,55603,0,10236233
CGATC,COPE-0760,1002264,19274,0,982990
TCGAT,COPE-0577,1080060,9808,0,1070252
TGCAT,COPE-0863,1106000,1698,0,1104302
CAACC,COPE-1142,5878340,11471,0,5866869
GGTTG,COPE-0991,3613280,6423,0,3606857
AAGGA,COPE-1188,16379154,68762,0,16310392
AGCTA,COPE-0924,8875024,30587,0,8844437
ACACA,COPE-1065,408784,45165,0,363619
AATTA,COPE-0722,5203810,29244,0,5174566
ACGGT,COPE-0945,1576816,3278,0,1573538
ACTGG,COPE-0868,4863836,12236,0,4851600
ACTTC,COPE-0981,6137316,9442,0,6127874
ATACG,COPE-0667,6273052,11582,0,6261470
ATGAG,COPE-1224,4357248,10059,0,4347189
ATTAC,COPE-0866,33906232,52997,0,33853235
CATAT,COPE-0655,2239702,3864,0,2235838
CGAAT,COPE-1227,4862866,10148,0,4852718
CGGCT,COPE-0559,2132284,14808,0,2117476
CGGTA,COPE-0612,3549870,28862,0,3521008
CGTAC,COPE-0911,10518896,19058,0,10499838
CGTCG,COPE-0556,9963618,13048,0,9950570
CTGAT,COPE-1047,6770474,12469,0,6758005
CTGCG,COPE-1244,73532,6921,0,66611
CTGTC,COPE-0680,4069848,10511,0,4059337
CTTGG,COPE-0915,213730,1831,0,211899
GACAC,COPE-0548,808528,6756,0,801772
GAGAT,COPE-0492,3144682,8349,0,3136333
GAGTC,COPE-0927,435170,2868,0,432302
GCCGT,COPE-0643,1396278,4766,0,1391512
GCTGA,COPE-1037,1343840,27387,0,1316453
GGATA,COPE-1095,11514196,34775,0,11479421
GGCCA,COPE-0747,374998,3648,0,371350
GGCTC,COPE-1021,1117018,2919,0,1114099
GTAGT,COPE-0842,4525666,5418,0,4520248
GTCCG,COPE-0909,4979766,10280,0,4969486
GTCGA,COPE-1007,17463504,56548,0,17406956
TACCG,COPE-1114,3202050,10762,0,3191288
TACGT,COPE-1234,35200396,35537,0,35164859
TAGTA,COPE-1053,3267526,50693,0,3216833
TATAC,COPE-0568,220374,4945,0,215429
TCACG,COPE-0852,838804,1956,0,836848
TCAGT,COPE-1247,43264,1701,0,41563
TCCGG,COPE-0844,60068,24555,0,35513
TCTGC,COPE-0689,11650,346,0,11304
TGGAA,COPE-0893,1824252,23840,0,1800412
TTACC,COPE-0625,209460,20346,0,189114
