GCATG,COPE-0704,1133066,4896,0,1128170
AACCA,COPE-1003,1858246,22544,0,1835702
CGATC,COPE-0537,2681548,16328,0,2665220
TCGAT,COPE-0731,2145708,7210,0,2138498
TGCAT,COPE-1004,2845044,2649,0,2842395
CAACC,COPE-0803,3494468,3747,0,3490721
GGTTG,COPE-0554,703050,1903,0,701147
AAGGA,COPE-0642,1624846,24222,0,1600624
AGCTA,COPE-0874,1078412,17666,0,1060746
ACACA,COPE-0982,8238518,47478,0,8191040
AATTA,COPE-0836,6662482,25590,0,6636892
ACGGT,COPE-0647,4094874,6303,0,4088571
ACTGG,COPE-0579,11005076,19127,0,10985949
ACTTC,COPE-0901,12594204,10864,0,12583340
ATACG,COPE-0607,10845666,15236,0,10830430
ATGAG,COPE-0508,10836314,19846,0,10816468
ATTAC,COPE-0882,3683900,20013,0,3663887
CATAT,COPE-0751,1420970,2623,0,1418347
CGAAT,COPE-0789,5580434,10121,0,5570313
CGGCT,COPE-0616,8823816,17799,0,8806017
CGGTA,COPE-1254,5057672,29712,0,5027960
CGTAC,COPE-1199,11303708,13468,0,11290240
CGTCG,COPE-1165,510036,3926,0,506110
CTGAT,COPE-0737,2566882,5054,0,2561828
CTGCG,COPE-0653,2060596,15355,0,2045241
CTGTC,COPE-0768,5186594,15844,0,5170750
CTTGG,COPE-1108,14255842,44906,0,14210936
GACAC,COPE-0949,1743410,8998,0,1734412
GAGAT,COPE-0518,760418,3578,0,756840
GAGTC,COPE-0611,11118790,13416,0,11105374
GCCGT,COPE-1048,12054460,12224,0,12042236
GCTGA,COPE-0802,132480,6865,0,125615
GGATA,COPE-1191,1931458,18342,0,1913116
GGCCA,COPE-1017,15664626,53863,0,15610763
GGCTC,COPE-0583,2207730,4659,0,2203071
GTAGT,COPE-1140,3461054,5474,0,3455580
GTCCG,COPE-0720,1429188,5351,0,1423837
GTCGA,COPE-0942,9947568,27780,0,9919788
TACCG,COPE-1034,4384480,9224,0,4375256
TACGT,COPE-1099,1231188,27760,0,1203428
TAGTA,COPE-1035,9967776,28171,0,9939605
TATAC,COPE-0734,7573544,20600,0,7552944
TCACG,COPE-0633,8378984,13311,0,8365673
TCAGT,COPE-1002,2471590,13736,0,2457854
TCCGG,COPE-0524,983460,57596,0,925864
TCTGC,COPE-0695,7005402,8169,0,6997233
TGGAA,COPE-0725,7032178,32092,0,7000086
TTACC,COPE-1083,19326,7309,0,12017
