GCATG,COPE-0908,12200006,17140,0,12182866
AACCA,COPE-1093,4968158,29438,0,4938720
CGATC,COPE-0634,7297626,20087,0,7277539
TCGAT,COPE-0816,2517890,4212,0,2513678
TGCAT,COPE-0805,5377148,4664,0,5372484
CAACC,COPE-1049,4779290,4704,0,4774586
GGTTG,COPE-0730,2386478,4058,0,2382420
AAGGA,COPE-0494,3764606,14117,0,3750489
AGCTA,COPE-1240,2851562,19565,0,2831997
ACACA,COPE-0597,7015446,28398,0,6987048
AATTA,COPE-0507,5512268,17909,0,5494359
ACGGT,COPE-0867,4499440,6855,0,4492585
ACTGG,COPE-0732,3615644,8638,0,3607006
ACTTC,COPE-0545,1225502,1377,0,1224125
ATACG,COPE-1230,8479364,10728,0,8468636
ATGAG,COPE-0485,1304778,4478,0,1300300
ATTAC,COPE-1022,31142,10866,0,20276
CATAT,COPE-1087,3079160,3403,0,3075757
CGAAT,COPE-1032,5198378,10103,0,5188275
CGGCT,COPE-0791,9993042,25148,0,9967894
CGGTA,COPE-0602,4884508,34424,0,4850084
CGTAC,COPE-0895,7724288,13483,0,7710805
CGTCG,COPE-0482,9719382,10474,0,9708908
CTGAT,COPE-0965,3984846,12962,0,3971884
CTGCG,COPE-0543,6472220,17055,0,6455165
CTGTC,COPE-1152,6490002,8631,0,6481371
CTTGG,COPE-1051,3719570,10118,0,3709452
GACAC,COPE-0812,3146646,9760,0,3136886
GAGAT,COPE-1127,1602832,4019,0,1598813
GAGTC,COPE-0477,1712312,2555,0,1709757
GCCGT,COPE-0790,3776068,6406,0,3769662
GCTGA,COPE-1056,8316816,82218,0,8234598
GGATA,COPE-1211,11942752,25957,0,11916795
GGCCA,COPE-0973,11011692,28295,0,10983397
GGCTC,COPE-1139,4415046,5266,0,4409780
GTAGT,COPE-1145,5205658,5413,0,5200245
GTCCG,COPE-1054,1604666,3214,0,1601452
GTCGA,COPE-1044,1692354,28901,0,1663453
TACCG,COPE-0522,6300196,11614,0,6288582
TACGT,COPE-0613,8054864,23192,0,8031672
TAGTA,COPE-0925,5885578,25812,0,5859766
TATAC,COPE-1107,4711002,12085,0,4698917
TCACG,COPE-0516,1880,315,0,1565
TCAGT,COPE-0684,2980696,2570,0,2978126
TCCGG,COPE-0793,794632,60187,0,734445
TCTGC,COPE-0549,411124,1659,0,409465
TGGAA,COPE-1029,2047518,12659,0,2034859
TTACC,COPE-0861,697922,4539,0,693383
