GCATG,COPE-0878,6956408,11225,0,6945183
AACCA,COPE-0941,7296694,24604,0,7272090
CGATC,COPE-0657,5919664,12025,0,5907639
TCGAT,COPE-0542,1628278,4068,0,1624210
TGCAT,COPE-0588,4114026,4680,0,4109346
CAACC,COPE-1014,4879140,5101,0,4874039
GGTTG,COPE-0638,4659886,7800,0,4652086
AAGGA,COPE-1030,5689436,19418,0,5670018
AGCTA,COPE-0718,5515120,17323,0,5497797
ACACA,COPE-0700,5785854,21660,0,5764194
AATTA,COPE-0809,4140430,17036,0,4123394
ACGGT,COPE-1122,4829820,3975,0,4825845
ACTGG,COPE-0932,4121012,7597,0,4113415
ACTTC,COPE-0752,5143136,3474,0,5139662
ATACG,COPE-0899,2815980,3935,0,2812045
ATGAG,Blank-2,1156180,2832,0,1153348
ATTAC,COPE-0479,3553644,12187,0,3541457
CATAT,COPE-0470,5483138,6442,0,5476696
CGAAT,COPE-0685,2089552,6105,0,2083447
CGGCT,COPE-0719,3482706,8648,0,3474058
CGGTA,COPE-0558,1205852,18009,0,1187843
CGTAC,COPE-0966,2548538,4637,0,2543901
CGTCG,COPE-0576,2555456,4428,0,2551028
CTGAT,COPE-0943,3008612,14355,0,2994257
CTGCG,COPE-1094,1139588,4284,0,1135304
CTGTC,COPE-0843,1518462,3444,0,1515018
CTTGG,COPE-1232,3474300,12233,0,3462067
GACAC,COPE-0888,2216864,8838,0,2208026
GAGAT,COPE-0944,2528880,4336,0,2524544
GAGTC,COPE-0798,2109842,4097,0,2105745
GCCGT,COPE-0729,3378422,6888,0,3371534
GCTGA,COPE-1041,1278824,26519,0,1252305
GGATA,COPE-0637,8313180,22069,0,8291111
GGCCA,COPE-1031,3336790,12483,0,3324307
GGCTC,COPE-0854,494420,1982,0,492438
GTAGT,COPE-1241,6005470,7284,0,5998186
GTCCG,COPE-1008,4212638,8156,0,4204482
GTCGA,COPE-0563,2620300,19462,0,2600838
TACCG,COPE-0674,8051022,19024,0,8031998
TACGT,COPE-0697,3065088,24525,0,3040563
TAGTA,COPE-1209,2370526,14456,0,2356070
TATAC,COPE-0478,1888842,4774,0,1884068
TCACG,COPE-0676,3880818,6179,0,3874639
TCAGT,COPE-0821,3942190,7973,0,3934217
TCCGG,COPE-0806,639628,77029,0,562599
TCTGC,COPE-0904,1226408,2261,0,1224147
TGGAA,COPE-0511,2906936,15846,0,2891090
TTACC,COPE-0564,9016,3699,0,5317
