GCATG,COPE-0631,5946344,19794,0,5926550
AACCA,COPE-0963,2221468,18070,0,2203398
CGATC,COPE-1086,2415194,13194,0,2402000
TCGAT,COPE-1082,1688336,4037,0,1684299
TGCAT,COPE-0487,1569404,5684,0,1563720
CAACC,COPE-1033,2717890,8019,0,2709871
GGTTG,COPE-0484,3188272,10969,0,3177303
AAGGA,COPE-1060,9510792,48319,0,9462473
AGCTA,COPE-0800,5487502,43367,0,5444135
ACACA,COPE-0472,859362,12339,0,847023
AATTA,COPE-1204,410320,3892,0,406428
ACGGT,COPE-0489,311210,11394,0,299816
ACTGG,COPE-0745,318406,2475,0,315931
ACTTC,COPE-1162,496656,2008,0,494648
ATACG,COPE-1214,762062,3356,0,758706
ATGAG,COPE-0551,3411558,16620,0,3394938
ATTAC,COPE-1151,429150,2110,0,427040
CATAT,COPE-0698,424942,2547,0,422395
CGAAT,COPE-1113,470804,3434,0,467370
CGGCT,COPE-0553,398230,9790,0,388440
CGGTA,COPE-0811,766068,18761,0,747307
CGTAC,COPE-1228,980748,5561,0,975187
CGTCG,COPE-0598,76604,2458,0,74146
CTGAT,COPE-1213,723912,8671,0,715241
CTGCG,COPE-0990,6818738,22533,0,6796205
CTGTC,COPE-0706,3527130,14187,0,3512943
CTTGG,COPE-0491,5568756,25444,0,5543312
GACAC,COPE-1238,11470300,63289,0,11407011
GAGAT,COPE-0841,7600898,19397,0,7581501
GAGTC,COPE-0663,15460460,52524,0,15407936
GCCGT,COPE-1068,10058392,21105,0,10037287
GCTGA,COPE-0976,3748392,37753,0,3710639
